1 1 1 1 1 1 1 @1 1 1 1 1 1 1 1 1 1 1 1 1 1 1 1 1
1 0 1 0 0 0 1 0 1 r g b y 1 0 0 0 0 0 0 0 0 0 1
1 0 1 0 1 0 1 0 1 h h h h 1 0 1 1 1 1 1 1 1 0 1
1 0 1 0 1 0 0 0 1 1 1 1 1 0 0 1 0 0 0 0 0 @2 0 1
1 0 1 0 1 1 1 0 1 h h h h 1 0 0 1 1 0 0 1 0 1 1
1 0 0 0 0 0 1 0 1 h h h 1 p 1 0 0 1 0 0 1 0 1 1
1 0 1 1 1 0 1 0 1 h h h 1 0 1 1 0 1 0 0 1 0 1 1
1 0 1 0 1 0 1 0 1 1 1 1 1 0 1 1 0 1 1 1 0 0 1 1
1 0 1 0 1 0 1 0 0 0 0 0 0 @2 0 0 0 0 0 0 0 0 1 1
1 0 1 0 1 0 1 1 1 0 1 1 1 1 0 1 0 1 1 1 0 1 0 1
1 0 1 0 1 0 0 0 0 0 1 1 1 1 0 1 0 1 1 1 0 1 0 1
1 0 1 0 0 0 1 1 1 0 0 0 0 0 0 1 0 1 0 0 0 0 0 1
1 @1 1 1 1 1 1 1 1 1 1 1 1 1 1 1 1 1 1 1 1 1 1 1