1 1 1 1 1 1 1 @1 1 1 1 1 1 1 1 1 1 1 1 1 1 1 1 1
1 0 1 0 0 0 1 0 1 0 0 0 0 0 0 0 0 0 0 0 0 0 0 1
1 0 1 0 1 b 1 0 1 0 0 0 0 0 0 0 0 0 0 0 0 0 0 1
1 0 1 0 1 0 0 0 1 0 0 0 0 0 0 0 0 0 0 r 0 0 0 1
1 0 1 0 1 1 1 0 1 0 0 0 0 1 0 0 0 1 0 0 0 0 0 1
1 0 0 0 0 0 1 0 1 0 0 0 1 p 1 0 0 1 0 0 0 0 0 1
1 0 1 1 1 0 1 0 1 0 0 0 1 0 1 1 0 1 0 0 0 g 0 1
1 0 1 0 1 0 1 0 1 1 1 1 1 0 1 1 0 1 1 1 0 0 0 1
1 0 1 0 1 0 1 0 y 0 0 0 0 0 0 0 0 0 0 0 0 0 0 1
1 0 1 0 1 0 1 1 1 0 1 1 1 1 0 1 0 1 1 1 0 0 0 1
1 0 1 0 1 0 0 0 0 0 1 1 1 1 0 1 0 1 0 0 0 0 0 1
1 0 1 0 0 0 1 1 1 0 0 0 0 0 0 1 0 1 0 0 0 0 0 1
1 @1 1 1 1 1 1 1 1 1 1 1 1 1 1 1 1 1 1 1 1 1 1 1